########   
#@# #  #   
# # #  #   
#      #   
##  #######
 #  #  #  #
 #  ####  #
 ##     $$#
  #      .#
  #  .#   #
  #########
