   #### 
   #@ # 
####  # 
#   $$##
# #  $ #
#..   .#
########
